NO      ./Makefile


SO ./Makefile
EA ./Makefile
WE ./Makefile
F 220,100,0
C 225,30,0



 11111111
 1111N111
	11111
