

NO ./pics/wood.xpm
SO ./pics/colorstone.xpm
EA ./pics/eagle.xpm
WE ./pics/mossy.xpm
F 110,100,0
C 115,30,0






11111111111111111111111111111111111111111
11110111111111011100000010001111111111111
11110111111011011101010010001111111111111
11000000110000101110000001001111111111111
10000000000100001100000010001111111111111
10000000000N10001101010010001111111111111
11111111111111111111111111111111111111111