

NO ./pics/wood.xpm
SO ./pics/colorstone.xpm
EA ./pics/eagle.xpm
WE ./pics/mossy.xpm
F 110,100,0
C 115,30,0






		1111111111111111111111111
		1000000000110000000000001
		1011000001110000000000001
		1001000000010000000000001
111111111011000001110000000000001
100000000011000001110111111101111
11110111111111011100000010001
11110111111011011101010010001
110000001101001011100000010001
10000000000000001100000010001
10000000000N10001101010010001
1100000111010101111101111000111
11110111 1110101 101111010001
11111111 1111111 111111111111