
NO ./pics/wood.xpm
SO ./pics/colorstone.xpm
EA ./pics/eagle.xpm
WE ./pics/mossy.xpm
F 110,100,0
C 115,30,0



 111
110011111111111111111    111
10001000000000011101011110101
10001000000000000001000100101
10000000000000000001000101001
10000000000000000001000100001  1
111111000000000011110001000001111111111111
1000011111110111100000000100000000001010001
1000100111000000100110000010000000000000001
1000000000000000101  111111011111111110011
1000000000000000101  10000101        101
1111100111001000111  11000101        101
1000001000000000101 110000101        101
1000000000000000100100110010111111111101
1000000000000000100100000010001001010101
1011111001111111101100000010011111111101
101    100000000001100000010100011100001
101   1100000000011100110110100000001001
111    111111111001101  11100001010010001
101             1010001100101000010010101
100111111111    1010000000101100000000101
1000000000011   1010000000101000000000101
10000000000111111011111111101111111101101
 1111111000100000000000000101010000000001
        101111111100100000001000000100101
        10000000001001111111111111111111
        10000000000000000000000000000001
 111111111111111100000000011111111111111
10000000000000000000000000000000000000001
10000000000000000000000000000000000000001
10000000000000000000000000001000000000001
10000000000000000000000000000000000010001  1
11111111111111111110000N00000000000010000111111111111111
100000000010000000000000000000000000000000000000000000001
100000000000000000000000000010000011000000000000000000001
1000000000000000000000000000000001  100000011111111111101
1000000000000000000000111000000001  10000101          101
1000000000000000000000111000000001  10000101          101
1000000000000000000000111000000001 100000101          101
10000000000000000000000000000000001100000001    11111 101
10000000000000000000000000000000001000000001   1000111101
10011111111111111111110011111110000000000000111100011 101
101                   10000000100000000000000001011111101
101                  110000000000000011000000000000000001
101                   111111111000001  1000000111011100001
101                            100000111000100000000000101
100111111111111111111111111    100000000000100000000000101
1001000000000000000000000001111000000000000100010000000101
1000000000000000000000000000000000000000000100000011111101
 111111111111111111111100000000000000000000100000000000001
                       10000010000000000000100000000010011
                       10000100000011111111 1111111111111
                       1000000000001
                        11111111111