

NO ./textures/wood.xpm
SO ./textures/colorstone.xpm
EA ./textures/eagle.xpm
WE ./textures/mossy.xpm
F 110,100,255
C 255,255,255



			11111111111111111111111
			10000000000000000001001
			100000000000011100010011111
			1000000000001   10000001001
			10000000000011111000000C001
11111111111111000000000W000C00001011111
10000000000000000001001111111111111
10000000000000000001001
11111111111111111111111