

NO ./textures/wood.xpm
SO ./textures/colorstone.xpm
EA ./textures/eagle.xpm
WE ./textures/mossy.xpm
F 110,100,255
C 255,255,255



1111111111111111111
10000000000000000001
100000C0000000000001
10000000000000000001
1000000000N000000001
10000000000000000001
10000000000000000001
11111111111111111111
