

NO ./textures/wood.xpm
SO ./textures/wood.xpm
EA ./textures/wood.xpm
WE ./textures/wood.xpm
F 110,100,255
C 255,255,255



		111111111111111111111
		100000000000010000001
		1000000000000C0000001
11111111100000000000010000001
1000000000N000000000111111111
100000000000000000001
100000000000000000001
111111111111111C11111
			100000001
			100000001
			1000000011111111111111111
			1000000000000000000000001
			1000000000000000000000001
			1000000000000000000000001
			1111111111111111111111111