

NO ./textures/wood.xpm
SO ./textures/colorstone.xpm
EA ./textures/eagle.xpm
WE ./textures/mossy.xpm
F 110,100,0
C 255,255,255






11111111111111111111111111111
11110111111111011100000010001
11110111111011011101010010001
11000000110000101110000001001
10000000000100001100000010001
11110111111011011101010010001
11000000110000101110000001001
10000000000100001100000010001
11110111111011011101010010001
11000000110000101110000001001
10000000000100001100000010001
11110111111011011101010010001
11000000110000101110000001001
11110111111011011101010010001
11000000110000101110000001001
10000000000100001100000010001
11110111111011011101010010001
11000000110000101110000001001
11000000110000101110000001001
10000000000100001100000010001
10000000000N10001101010010001
11111111111111111111111111111
