
NO ./textures/wood.xpm
SO ./textures/wood.xpm
EA ./textures/wood.xpm
WE ./textures/wood.xpm

F 200,200,159
C 0,100,255



11111
1100111111111111111111   1111
10001000000000011101011110101
10001000000000000001000100101
10000000000000000001000101001
10000000000000000001000100001  
1111110000000000111100010000011111111111111
1000011111110111100000000100000000001010001
1000100111000000100110000010000000000000001
10000000000000001011 1111110111111111100111
1000000000000000101  100001011       1011
1111100111001000111  11000101        101
1000001000000000101 110000101        101
1000000000000000100100110010111111111101
1000000000000000100100000010001001010101
1011111001111111101100000010011111111101
101    100000000001100000010100011100001
101    1000000000111011111101000000010011
111    111111111001101    100001010010001
101             1010011111101000010010101
100111111111    1010000000101100000000101
100000000001    1010000000101000000000101
10000000000111111011111111101111111101101
11111111000100000000000000101010000000001
       1101111111100100000001000000100101
        100000000010000000000000011111111
        1000000000C000000000000000000001
11111111111111111C1111111111111111111111
10000000000000010001000000000000000000011
10000000000000110001100000000000000000001
10000000000000000000000000001000000000001
10000000000000000000000000000000000010001  
11111111111111111110000N000000000000100001111111111111111
100000000010000000000000000000000000000000000000000000001
100000000000000000000000000010000111000000000000000000001
1000000000000000000000000000000001  100000011111111111101
1000000000000000000000111000000001  10000101          101
1000000000000000000000111000000001 110000101          101
1000000000000000000000111000000001 100000101          101
10000000000000000000000000000000011100000001   111111 101
10000000000000000000000000000000001000000001   1000111101
10011111111111111111110011111110000000000000111100011 101
101                  110000000100000000000000001011111101
101                   100000000000001111000000000000000011
101                   111111111100001  1000000111011100001
101                            100001111000100000000000101
1001111111111111111111111111   100000000000100000000000101
1001000000000000000000000001111100000000000100010000000101
1000000000000000000000000000000000000000000100000011111101
1111111111111111111111100000000000000000000100000000000001
                       10000010000000000001110000000010011
                       10000100000011111111 11111111111111
                       1000000000001
                       1111111111111