

NO ./pics/wood.xpm
SO ./pics/colorstone.xpm
EA ./pics/eagle.xpm
WE ./pics/mossy.xpm
F 110,100,255
C 255,255,255



1111111111111111
1000000000000001
1000000000000001
10000N0000000001
1000000000000001
1000000010000001
1000000000000001
1000000000000001
1111111111111111