

NO ./pics/wood.xpm
SO ./pics/colorstone.xpm
EA ./pics/eagle.xpm
WE ./pics/mossy.xpm
F 110,100,255
C 255,255,255



11111111111111111111
10000000000000000001
10000000000000000001
10000000000000000001
1000000000N000000001
10000000000000000001
10000000000000000001
11111111111111111111